#### #####
##X  #####
####  X###
##   X####
##F#######